NO north.xpm
EA east.xpm
SO wall.xpm
WE samoyed.xpm
R 640 480
F 155,169,91
C 184,225,233
S sprite.xpm

1111111111111111111111
1002000011110001010001
1000001111001001010001
1111101001000011010001
1000001001000021010001
1100001001000001010001
11100000000120E0020001
1110001111110001110001
1000000000000020000001
1111111111111111111111