R 1080 720
NO ./textures/bluestone.xpm
EA ./textures/greystone.xpm
SO ./textures/mossy.xpm
WE ./textures/north.xpm
S ./textures/sprite.xpm
C 255,240,132
F 122,122,122

11111111111111111
1000000000000000111111
1020000020000020100001
1000000000000000000001
1000200020002000111111
10000000000000001
10202020N02020201
10000000000000001
10002000200200001
10000000000000001
10200000200002001
10000000000000001
11111111111111110