NO ./textures/north.xpm
EA ./textures/east.xpm
SO ./textures/south.xpm
WE ./textures/west.xpm
S ./textures/sprite.xpm
R 640       	                 480
F 102,     102,     255
C 186,       235,       245


2111111111111111111111111111111111100000000001
10000000000000100000000200020011111111111111111
11000000000000000000000000000000000000000000001
11000000000000000000000000000000001000000000001
11111110000000111111111111111111111111100001111
11111110001111111111110111111111111100000N00001
00000011111000000000011100000000011111111111111