S ./textures/pillar.xpm
	R 900 600


	NO ./textures/north.xpm
           SO ./textures/south.xpm



11111111111111111111111111111
10000000201100000000000000001
10110000011100000020000010001
10010000000000200000000010001
10110000011100000200000010011
10000000001100000111011110021
11110111111111011100000010021
11110111111111011101010010021
11000000110101011100000010201
10002000000000001100000010001
10000000000000001101010010001
10000000000000001101010010N01
11000000110101011111011110001
11110111111101011111011110001
11111111111111111111111111111
10002000000000001100000010001
10000000000000001101010010001
11111111111111111110011111111
WE ./textures/west.xpm
EA ./textures/east.xpm


F 184,113,39
C 51,198,227
