NO ./textures/north.xpm
EA ./textures/east.xpm
SO ./textures/south.xpm
WE ./textures/west.xpm
S ./textures/sprite.xpm
R 640       	                 480
F 102,     102,     255
C 186,       235,       245

00000000000000000000000000000000000111111111111
11111111111111111111111111111111111100000000001
11000000000000000000000000000001000000002000200111111111111111111111111111111111
110000000000000000000000000000010000000000000000000000000000000000000000000001
110000000000000000000000000000000000000000000000000000000000000001000000000001
1111111111111111111111011111111111110000000000111111111111111111111111111111111
11111110111111111111110111111111111100000N00001
0000000000000000000001110000000001111111111111