R 1080 720
NO ./textures/bluestone.xpm
EA ./textures/greystone.xpm
SO ./textures/mossy.xpm
WE ./textures/north.xpm
S ./textures/sprite.xpm
C 255,200,160
F 122,122,122

        1111111111111111111111111
        1000000000110000000000001
        1011000001110000002000001
        1001000000000000000000001
111111111011000001110000000000001
100000000011000001111111111111111
11110111111111011100000010001
11110111111111010101010010001
11000000110101011100000012001
10002000000000001100000000001
10000000000000001101010010001
11000001110101011111011110N01
11110111 1110101 101111010001
11111111 1111111 111111111111